Lab1=Material:
Lab2=Statistik:
Err=Mit diesem Material kann man nicht schmieden.
Inspect=Legierungsprüfung
Mass=Masse: %d %s
Speed=Geschwindigkeit: %d %s
Power=Leistung: %d %s
Ok=(OK)
Good=(GUT)
Bad=(SCHLECHT)
Lab3=Eigenschaften:
Burnable=Brennbar
Fuming=^ Setzt beim Verbrennen auch Rauch frei!
Meltable=Schmilzt langsam in Lava
HTM=^ Oder bei hohen Temperaturen!
Windy=Wird vom Wind weggeweht
Float=Schwimmt auf Wasser
LQM=Schmilzt in:
WaterLQM=^ Wasser
LavaLQM=^ Lava
AcidLQM=^ Säure
OilLQM=^ Öl
Regen=Repariert sich langsam selbst
Glide=Gleitet in der Luft
Toxic=Vergiftet langsam Lebewesen und Clonk in der Nähe
Skew=Seltsam wackelig
Glow=Leuchtet in einem kleinen Bereich um sich herum
Explode=Explodiert beim Aufprall
Fragile=Zerbricht beim Aufprall
Lightning=Zieht Blitze an
Sticky=Haftet an jeder Oberfläche
Bouncy=Springt von der Landschaft ab